5
10
OOOOOOOOOO
OOSSSSSOKO
OOSOSSOSOO
OMSSSSSSSO
OOOOOOOOOO
