5
10
OOOOOOOOOO
OSSSSSSSKO
OSSSSSSSSO
OMSSSSSSSO
OOOOOOOOOO
