6
9
OOOOOOOOO
OSSSSSOKO
OSOOSSOOO
OSOSSSSSO
OMOKOOSOO
OOOOOOOOO
